NO             ./assets/textures/north.xpm

SO ./assets/textures/south.xpm
WE      ./assets/textures/west.xpm
EA     ./assets/textures/east.xpm

F     220,   100,55
C   225,30,0

        1111111111111111111111111
        1000000000110000000000001
        1011000001110000000000001
        1001000000000000000000001
111111111011000001110000000000001
100000000011000001110111100111111
11110111111111011100000010001
111101111111110111010100100011111111111111111111
110000001101010111000000100000000000000000000001
100000000000000011000000100011111111111111000001
10000000000000001101010010001            1111101111
1100000111010101111101111000111          1000000001
11110111 1110101 101111010001            1000S00001
11111111 1111111 111111111111            1111111111