NO             ./assets/textures/north.xpm

SO ./assets/textures/south.xpm
WE      ./assets/textures/west.xpm
EA     ./assets/textures/east.xpm

F     220,   100,0
C   225,30,0

1111111111
1000000001
100N000001
1000000001
1000000001
1111111111



